                  ##########
                  ##S....E##
                ######GG######
              ####..........####
            ####...+..M...+...####
          ####.........M........####
        ####..+................+..####
      ####......M......M............####
    ####..+........................+..####
  ####.....................M.........M..####
####..+.........M...............M......+..####
##.M........M.......M.......................##
####..+....................M...........+..####
  ####.......M....................M.....####
    ####..+........................+..####
      ####.......M.....M.....M......####
        ####..+................+..####
          ####......M...........####
            ####...+......+...####
              ####......M...####
                ######GG######
                  ##+....+##
                  ##########