##############
#..M.........###########
#......G..#..#.S.......#
#.........#..#######...#
#+..M.....#............#
####......#..#.........#
#E.......+#..#..M......#
###########..###########
#M..............#.....E#
####...####..####...####
#.........#..#.......+.#
#...M..G..#M.#.........#
#.........#.+#....M....#
#G...M....####.........#
#......................#
#......................#
########################